                                   
                    CC             
                  CCCCCCC          
                                   
                                   
                G                  
                GGGG               
   G           GGGGGG              
GGGGGGG  GGGGGGGGGGGGGGGGGGGGGGGGGG
SSSSSS   SSSSSSSSSSSSSSSSSSSSSSSSSS
SSSSS   SSSSSSSSSSSSSSSSSSSSSSSSSSS
SSSS  S  SSSSSSSSSSSSSSSSSSSSSSSSSS
SSSSSSSS SSSSSSSSSSSSSSSSSSSSSSSSSS
SSSSSSSSSSSSSSSSSSSSSSSSSSSSSSSSSSS
SSSSSSSSSSSSSSSSSSSSSSSSSSSSSSSSSSS
SSSSSSSSSSSSSSSSSSSSSSSSSSSSSSSSSSS
SSSSSSSSSSSSSSSSSSSSSSSSSSSSSSSSSSS
SSSSSSSSSSSSSSSSSSSSSSSSSSSSSSSSSSS
SSSSSSSSSSSSSSSSSSSSSSSSSSSSSSSSSSS
SSSSSSSSSSSSSSSSSSSSSSSSSSSSSSSSSSS
SSSSSSSSSSSSSSSSSSSSSSSSSSSSSSSSSSS
SSSSSSSSSSSSSSSSSSSSSSSSSSSSSSSSSSS
SSSSSSSSSSSSSSSSSSSSSSSSSSSSSSSSSSS