                C                  
                                   
C                                  
                             V     
                            VVV    
                G          VVLVV   
                DGGG         L     
   G        T  GDDDDG        L     
GGGDGGG  GGGGGGDDDDDDGGGGGGGGGGGGGG
DDDDSS   SDDDDDDDDDDDDDDDDDDDDDDDDD
SSSSS   SSSSSSDDDDDDDDDDDDDDDDDDDSS
SSSS  S  SSSSSSSSSSSSSSSSSSSSSSDDDD
SSSSSSSS SSSSSSSSSSSSSSSSSSSSSSSSSS
SSSSSSSSSSSSSSSSSSSSSSSSSSSSSSSSSSS
SSSSSSSSDDDSSSSSSSSSSSSSSSSSSSSSSSS
SSSSSSSSSSSSSSSSSSSSSSSSSSSSSSSSSSS
SSSSSSSSSSSSSSDDDSSSSSSSSSSSSSSSSSS
SSSSSSSSSSSSSSSSSSSSSSSSSSSSSSSSSSS
SSSDDDDDSSSSSSSSSSSSSSSSSSSSSSSSSSS
SSSSSSSSSSSSSSSSSSSSSSSSSSSSSSSSSSS
SSSSSSSSSSSSSSSSSSSSSSSSSSSSSSSSSSS
SSSSSSSSSSSSSSSSSSSSSSSSSSSSSSSSSSS
SSSSSSSSSSSSSSSSSSSSSSSSSSSSSSSSSSS
BBBBBBBBBBBBBBBBBBBBBBBBBBBBBBBBBBB