                D                 
                DDDD              
   D           DDDDDD             
DDDDDDD  DDDDDDDDDDDDDDDDDDDDDDDDD
SSSSSS   SSSSSSSSSSSSSSSSSSSSSSSSS
SSSSS   SSSSSSSSSSSSSSSSSSSSSSSSSS
SSSS  S  SSSSSSSSSSSSSSSSSSSSSSSSS
SSSSSSSS SSSSSSSSSSSSSSSSSSSSSSSSS
SSSSSSSSSSSSSSSSSSSSSSSSSSSSSSSSSS
SSSSSSSSSSSSSSSSSSSSSSSSSSSSSSSSSS
SSSSSSSSSSSSSSSSSSSSSSSSSSSSSSSSSS
SSSSSSSSSSSSSSSSSSSSSSSSSSSSSSSSSS
SSSSSSSSSSSSSSSSSSSSSSSSSSSSSSSSSS
SSSSSSSSSSSSSSSSSSSSSSSSSSSSSSSSSS
SSSSSSSSSSSSSSSSSSSSSSSSSSSSSSSSSS
SSSSSSSSSSSSSSSSSSSSSSSSSSSSSSSSSS
SSSSSSSSSSSSSSSSSSSSSSSSSSSSSSSSSS