                                                                
                                                                
                                                                
                                                                
                                                                
                                                                
                                                                
                                                                
                                                                
                                                                
                                                                
    G                           G      GG         GGG           
L  GDG             T           GDG    GDDG       GDDDG   L    L 
GGGDDDG  GGGGGGGGGGGGGGGGG    GDDDGGGGDDDDGL    GDDDDDGGGGGGGGGG
DDDDDDDGGDDDDDDDDDDDDDDDDD   GDDSDDDDDDDDDDG   GDDDDDDDDDDDDDDDD
DDDDDDDDDDDDDDDDDDDDDDDDDDG  DDDSDDDDDSSSDDDG GDDDDDSDDDDDDDDDDD
DDSSSSDDDDDDDDDDSSDSSSDDDSDGGDDSSSDDDDDDSDSDDGDDDSDSSDSDDDDDSDDD
DSSDSDDDDDDDDSDSDSDSSSSDDDDDDDDSSSDDDDSSSSDDDDDDSSSSSDSSSDDDSDDS
DSDSSSSSDSSDSSSSSSSSSSSDSSDDDSSSSSSSSSSSSSSSSDDSDSSSSSSSSSSDSDSS
SSSSSSSSDSSSSSSSSSSSSSSSSSDSDDSSSSSSSSSSSSSDDDDSSSSSSSSSSSSSSSSS
SSSSSSSSSSSSSSSSSSSSSSSSSSSDDSSSSSSSSSSSSSSSSDSSSSSSSSSSSSSSSSSS
SSSSSSSSSSSSSSSSSSSSSSSSSSSSSSSSSSSSSSSSSSSSSSSSSSSSSSSSSSSSSSSS
SSSSSSSSSSSSSSSSSSSSSSSSSSSSSSSSSSSSSSSSSSSSSSSSSSSSSSSSSSSSSSSS
SSSSSSSSSSSSSSSSSSSSSSSSSSSSSSSSSSSSSSSSSSSSSSSSSSSSSSSSSSSSSSSS
SSSSSSSSSSSSSSSSSSSSSSSSSSSSSSSSSSSSSSSSSSSSSSSSSSSSSSSSSSSSSSSS
SSSSSSSSSSSSSSSSSSSSSSSSSSSSSSSSSSSSSSSSSSSSSSSSSSSSSSSSSSSSSSSS
SSSSSSSSSSSSSSSSSSSSSSSSSSSSSSSSSSSSSSSSSSSSSSSSSSSSSSSSSSSSSSSS
SSSSSSSSSSSSSSSSSSSSSSSSSSSSSSSSSSSSSSSSSSSSSSSSSSSSSSSSSSSSSSSS
SSSSSSSSSSSSSSSSSSSSSSSSSSSSSSSSSSSSSSSSSSSSSSSSSSSSSSSSSSSSSSSS
SSSSSSSSSSSSSSSSSSSSSSSSSSSSSSSSSSSSSSSSSSSSSSSSSSSSSSSSSSSSSSSS
SSSSSSSSSSSSSSSSSSSSSSSSSSSSSSSSSSSSSSSSSSSSSSSSSSSSSSSSSSSSSSSS
SSSSSSSSSSSSSSSSSSSSSSSSSSSSSSSSSSSSSSSSSSSSSSSSSSSSSSSSSSSSSSSS
SSSSSSSSSSSSSSSSSSSSSSSSSSSSSSSSSSSSSSSSSSSSSSSSSSSSSSSSSSSSSSSS
SSSSSSSSSSSSSSSSSSSSSSSSSSSSSSSSSSSSSSSSSSSSSSSSSSSSSSSSSSSSSSSS
SSSSSSSSSSSSSSSSSSSSSSSSSSSSSSSSSSSSSSSSSSSSSSSSSSSSSSSSSSSSSSSS
SSSSSSSSSSSSSSSSSSSSSSSSSSSSSSSSSSSSSSSSSSSSSSSSSSSSSSSSSSSSSSSS
