                                                                
                                                                
                                                                
                                                                
                                                                
                                V                               
                   V           VVV                              
     V            VVV          VVV                              
    VVV           VVV          VLV                              
    VVV           VLV           L                               
    VLV            L G          LG                              
     L             LGDG         GDG                             
 GG  L       G     GDDD  T     GDDDG          G                 
GDDGGGGGGG  GDGG  GDDDDGGG    GDDDDDGG GGGGGGGDGGG GGGGG   GGGGG
DDDDDDDDDDGGDDDDGGDDDSDDDD   GDDDSSDDDGDDDDDDDDDDDGDDDDDGGGDDDDD
DSDDDDDDDDDDDDDDDDDDDSDDDDGGGDDSSSSDDDDDDDDDDDDDDDDDDDDDDDDDDDDD
DDSDSDDDDSDDSSSDDDDDDSSDDDDDDDDSSSSSDDDDDDSDDSSDDDDDDDDSDDDDDDDD
SSSSSDSSSDDDSSDDSDSDSSSSSDDDDDSSSSSDDDDSSDDDDSSSDDDDSDDDDSDSSSSD
SSSSSSSSSSSDDSDSDDSSSSSDSSDDDSSSSSSSSSDSSSSDSSSSSDDSSSDSDDDSDSSS
SSSSSSSSSSSDSSSSSDSSSSSSSSSSSSSSSSSSSSDSSSSSSSSSSSDSSSSSSSSSSSSS
SSSSSSSSSSSSSSSSSSSSSSSSSSSSSSSSSSSSSSSSSSSSSSSSSSSSSSSSSSSSSSSS
SSSSSSSSSSSSSSSSSSSSSSSSSSSSSSSSSSSSSSSSSSSSSSSSSSSSSSSSSSSSSSSS
SSSSSSSSSSSSSSSSSSSSSSSSSSSSSSSSSSSSSSSSSSSSSSSSSSSSSSSSSSSSSSSS
SSSSSSSSSSSSSSSSSSSSSSSSSSSSSSSSSSSSSSSSSSSSSSSSSSSSSSSSSSSSSSSS
SSSSSSSSSSSSSSSSSSSSSSSSSSSSSSSSSSSSSSSSSSSSSSSSSSSSSSSSSSSSSSSS
SSSSSSSSSSSSSSSSSSSSSSSSSSSSSSSSSSSSSSSSSSSSSSSSSSSSSSSSSSSSSSSS
SSSSSSSSSSSSSSSSSSSSSSSSSSSSSSSSSSSSSSSSSSSSSSSSSSSSSSSSSSSSSSSS
SSSSSSSSSSSSSSSSSSSSSSSSSSSSSSSSSSSSSSSSSSSSSSSSSSSSSSSSSSSSSSSS
SSSSSSSSSSSSSSSSSSSSSSSSSSSSSSSSSSSSSSSSSSSSSSSSSSSSSSSSSSSSSSSS
SSSSSSSSSSSSSSSSSSSSSSSSSSSSSSSSSSSSSSSSSSSSSSSSSSSSSSSSSSSSSSSS
SSSSSSSSSSSSSSSSSSSSSSSSSSSSSSSSSSSSSSSSSSSSSSSSSSSSSSSSSSSSSSSS
SSSSSSSSSSSSSSSSSSSSSSSSSSSSSSSSSSSSSSSSSSSSSSSSSSSSSSSSSSSSSSSS
SSSSSSSSSSSSSSSSSSSSSSSSSSSSSSSSSSSSSSSSSSSSSSSSSSSSSSSSSSSSSSSS
SSSSSSSSSSSSSSSSSSSSSSSSSSSSSSSSSSSSSSSSSSSSSSSSSSSSSSSSSSSSSSSS
SSSSSSSSSSSSSSSSSSSSSSSSSSSSSSSSSSSSSSSSSSSSSSSSSSSSSSSSSSSSSSSS
BBBBBBBBBBBBBBBBBBBBBBBBBBBBBBBBBBBBBBBBBBBBBBBBBBBBBBBBBBBBBBBB
